- ActiveCoreObjects: farming-framework-api/activecoreobjects.md
- AreaLoaders: farming-framework-api/arealoaders.md
- Areas: farming-framework-api/areas.md
- Buffs: farming-framework-api/buffs.md
- CameraDirectionInteractionModule: farming-framework-api/cameradirectioninteractionmodule.md
- CoreHierarchyReplicator: farming-framework-api/corehierarchyreplicator.md
- Crafting: farming-framework-api/crafting.md
- Currency: farming-framework-api/currency.md
- CursorInteractionModule: farming-framework-api/cursorinteractionmodule.md
- Database: farming-framework-api/database.md
- DataMigration: farming-framework-api/datamigration.md
- Drops: farming-framework-api/drops.md
- Equipment: farming-framework-api/equipment.md
- Gatherables: farming-framework-api/gatherables.md
- IconManager: farming-framework-api/iconmanager.md
- InteractionManager: farming-framework-api/interactionmanager.md
- Inventory: farming-framework-api/inventory.md
- ItemPickups: farming-framework-api/itempickups.md
- LookInteractionModule: farming-framework-api/lookinteractionmodule.md
- Placeables: farming-framework-api/placeables.md
- PlacementAreas: farming-framework-api/placementareas.md
- PlayerLots: farming-framework-api/playerlots.md
- PlayerUpgrades: farming-framework-api/playerupgrades.md
- PointerInteractionModule: farming-framework-api/pointerinteractionmodule.md
- ProducerBases: farming-framework-api/producerbases.md
- Purchasing: farming-framework-api/purchasing.md
- RealTime: farming-framework-api/realtime.md
- ReliableEvents: farming-framework-api/reliableevents.md
- SpawnPoints: farming-framework-api/spawnpoints.md
- Spectator: farming-framework-api/spectator.md
- StringChunk: farming-framework-api/stringchunk.md
- Tags: farming-framework-api/tags.md
- TimeSimulator: farming-framework-api/timesimulator.md
- Tooltiip: farming-framework-api/tooltiip.md
- TriggerInteractionModule: farming-framework-api/triggerinteractionmodule.md
- TypedBitString: farming-framework-api/typedbitstring.md
- UILibrary: farming-framework-api/uilibrary.md
